0000000000000000
0011111111000120
0111100001111110
0100100400010150
0501111110010000
0100010000011100
0100000001000100
0100011111000100
0111000001111100
0001000000000000
0111111111111000
0100000100001000
0100030100001100
0111061100000110
0001110111111600
0000000000000000