0000000000000000
0000000000000000
0000000400000000
0001111111160000
0001115111110000
0001161121510000
0001111511110000
0001110001110000
0000011311000000
0000011111000000
0000000000000000
0000000000000000
0000000000000000
0000000000000000
0000000000000000
0000000000000000
