0000000000000000
0001000011112010
0401005111111010
0101000000100010
0111111100111110
0100000000100100
0111001111100100
0001001000000000
0101111111110030
0101000001010010
0101111001010010
0101001001011110
0100001001001000
0111161101001000
0000000001001110
0000000000000000