0000000000000000
0111611100000300
0100101111101610
0000100000101110
0011100000100010
0000100100100010
0111100100111110
0100000100000000
0100000111110000
0100000100520040
0100000100000010
0111110111111110
0100000100000010
0100100111111110
0111111100050000
0000000000000000