0000000000000000
0250111110000300
0110010000000100
0111010000011100
0001011115111100
0011011100000100
0110000100111110
0100010100000010
0100010111110000
0100010000011100
0111010000010110
0001011111150010
0056000000060010
0001000400010010
0001111111110010
0000000000000000